18
20 
7
0 0 0 0 0 0 0 0 0 0 0 0 0 0 0 0 0 0 0 0
0 0 0 0 0 0 0 0 0 0 0 0 0 0 0 0 0 0 0 0
0 0 0 0 0 0 0 0 0 0 0 0 0 0 0 0 0 0 0 0
0 0 0 0 1 1 1 1 1 0 0 0 0 0 0 0 0 0 0 0
0 0 0 0 1 2 2 2 1 0 0 0 0 0 0 0 0 0 0 0
0 0 0 0 1 5 2 2 1 0 0 0 0 0 0 0 0 0 0 0
0 0 1 1 1 2 2 5 1 1 0 0 0 0 0 0 0 0 0 0
0 0 1 2 2 5 2 5 2 1 0 0 0 0 0 0 0 0 0 0
1 1 1 2 1 2 1 1 2 1 1 1 1 1 1 1 1 1 1 0
1 2 2 2 1 2 1 1 2 1 1 1 1 1 2 2 3 3 1 0
1 2 5 2 2 5 2 2 2 2 2 2 2 2 2 2 3 3 1 0
1 1 1 1 1 2 1 1 1 2 1 4 1 1 2 2 3 3 1 0
0 0 0 0 1 2 2 2 2 2 1 1 1 1 1 1 1 1 1 0
0 0 0 0 1 1 1 1 1 1 1 0 0 0 0 0 0 0 0 0
0 0 0 0 0 0 0 0 0 0 0 0 0 0 0 0 0 0 0 0
0 0 0 0 0 0 0 0 0 0 0 0 0 0 0 0 0 0 0 0
0 0 0 0 0 0 0 0 0 0 0 0 0 0 0 0 0 0 0 0
0 0 0 0 0 0 0 0 0 0 0 0 0 0 0 0 0 0 0 0
