18
20
21
0 0 0 0 0 0 0 0 0 0 0 0 0 0 0 0 0 0 0 0
0 0 0 0 0 0 0 0 0 0 0 0 0 0 0 0 0 0 0 0
0 0 0 0 0 0 0 0 0 0 0 1 1 1 1 1 1 1 1 0
0 0 0 0 0 0 0 0 0 0 0 1 2 2 3 3 3 3 1 0
1 1 1 1 1 1 1 1 1 1 1 1 2 2 3 3 3 3 1 0
1 2 2 2 2 1 2 2 5 2 5 2 2 2 3 3 3 3 1 0
1 2 5 5 5 1 5 2 2 5 2 1 2 2 3 3 3 3 1 0
1 2 2 5 2 2 2 2 2 5 2 1 2 2 3 3 3 3 1 0
1 2 5 5 2 1 5 2 5 2 5 1 1 1 1 1 1 1 1 0
1 2 2 5 2 1 2 2 2 2 2 1 0 0 0 0 0 0 0 0
1 1 2 1 1 1 1 1 1 1 1 1 0 0 0 0 0 0 0 0
1 2 2 2 2 1 2 2 2 2 1 0 0 0 0 0 0 0 0 0
1 2 2 2 2 2 5 2 2 2 1 1 0 0 0 0 0 0 0 0
1 2 2 5 5 1 5 5 2 2 4 1 0 0 0 0 0 0 0 0
1 2 2 2 2 1 2 2 2 2 1 1 0 0 0 0 0 0 0 0
1 1 1 1 1 1 1 1 1 1 1 0 0 0 0 0 0 0 0 0
0 0 0 0 0 0 0 0 0 0 0 0 0 0 0 0 0 0 0 0
0 0 0 0 0 0 0 0 0 0 0 0 0 0 0 0 0 0 0 0
