18
20
11
0 0 0 0 0 0 0 0 0 0 0 0 0 0 0 0 0 0 0 0
0 0 0 0 0 0 0 0 0 0 0 0 0 0 0 0 0 0 0 0
0 0 0 0 0 0 0 0 0 0 0 0 0 0 0 0 0 0 0 0
0 0 0 0 0 0 0 0 0 0 0 0 0 0 0 0 0 0 0 0
0 0 0 0 1 1 1 1 1 1 1 1 1 1 1 1 0 0 0 0
0 0 0 0 1 3 3 2 2 1 2 2 2 2 2 1 1 1 0 0
0 0 0 0 1 3 3 2 2 1 2 5 2 2 5 2 2 1 0 0
0 0 0 0 1 3 3 2 2 1 5 1 1 1 1 2 2 1 0 0
0 0 0 0 1 3 3 2 2 2 2 4 2 1 1 2 2 1 0 0
0 0 0 0 1 3 3 2 2 1 2 1 2 2 5 2 1 1 0 0
0 0 0 0 1 1 1 1 1 1 2 1 1 5 2 5 2 1 0 0
0 0 0 0 0 0 1 2 5 2 2 5 2 5 2 5 2 1 0 0
0 0 0 0 0 0 1 2 2 2 2 1 2 2 2 2 2 1 0 0
0 0 0 0 0 0 1 1 1 1 1 1 1 1 1 1 1 1 0 0
0 0 0 0 0 0 0 0 0 0 0 0 0 0 0 0 0 0 0 0
0 0 0 0 0 0 0 0 0 0 0 0 0 0 0 0 0 0 0 0
0 0 0 0 0 0 0 0 0 0 0 0 0 0 0 0 0 0 0 0
0 0 0 0 0 0 0 0 0 0 0 0 0 0 0 0 0 0 0 0
